#####
#p  #
#   #
#k  #
#   #
#  G#
#####