##############
#p    #      #
#            #
# ########## #
#    G#k     #
##############