#######
#p    #
#     #
#     #
# #k#G#
#######