##########################
#   #                #   #
#   # ### ########## # # #
# # # # #     #    ### #k#
# # # # #     # #      ###
# #   # # ##### ######   #
# # p # #       #    ### #
# ##### # ####### #  # # #
#       #         #    #G#
##########################