#####
#p  #
#   #
#G  #
#   #
#  k#
#####