#############
#p          #
# ####### # #
# # #   # # #
# # #k#   # #
#   ### ### #
# # #   #G  #
#############